...####.....#
..##....###.#
.##.....##..#
##.....#....#
#....@..#...#
#.......#...#
####.........
######..#...#
#.......#...#
#.#######...#
#.........###
###########